1	1
2	1
1001	1
1002	1
1003	1
1004	1
1005	1
1006	1
1007	1
1008	1
1009	1
1010	2
1011	2
1015	1
1016	1
1019	1
1022	1
1025	1
1029	1
1033	1
1036	1
1037	3
1038	1
1046	1
1048	1
1051	1
1054	1
1057	1
1059	1
1064	1
1068	1
1074	1
1079	1
1082	1
1085	1
1088	1
1090	1
1096	1
1099	1
1103	1
1107	1
1108	1
1109	1
1110	1
1112	2
1113	1
1114	3
1115	1
1116	1
1117	3
1118	3
1119	3
1120	3
